...#..................#..................X#......................#......XXXXXXXXXXXXXXXXXXXXXXXX#.............................#...
....#.................XXXXXX#........#.#.X............##...........#....X#..........#..........X...............#..................
.............#........X....X...........XXXXXXXXXXXXXXXXXXXXXXXXXXXXXXXXXXXXXXXXXXXXXXX#........X#.#..#..#..........#..............
..........#.......#...X....X.#.........X.X......#........##.............X.....#......X.......#.X...................XXXXXXXXXXXXXXX
....................#.X....X...........X.X..............................X......#..#..X.........X...................X....#........X
....#.................X....X.....#.....X.X..............................X.......#....X.........X......#..........##X...#.........X
.......#.............#XXXXXXXXXXXXXXXXXXXXXXXXXXXXXXXXXXXXXXXXXXXXXXXXXXXXXXXXXXXXXXXX......#..X..........#........X#............X
....###....................X.#....#....X.X....#.....#...................X............#.........X................#..X.............X
......XXXX#..#...........#.X#..........X.X....XXXXXXXXXXXXXXXXXXXXXXXXXXXXXXXXXXXXXXX#.....#...X.......#...........X....#........X
..#...X#.X....#....#....#XXXXXXXXXXXXXXXXXXXXXXXXXXXXXXXXXXXXXXXXXXXXXXXXXXXXXXXXXXXXXXXXXXX#..X...................X.............X
......X..X..........#....X.X.....#.....X.X....X.........................X.....#.....X#....#X...X...................X......#......X
......X..X#.......#......X.X#.......#..X.X....X.........................X...........X......X...X...................X.............X
......X#.X.#.............X.XXXXXXXXXXXXXXXXXXXXXXXX#...................#XXXXXXXXXXXXXXXXXXXXXXXXXXXXXXXXXXXXXXXXXXXXXXXXXXXXXXXXXX
......X#.X......#........X.XX..........X.X...#X...X#.......#........................X......X...X..........#........X.........#...#
......X..X...........#...X.XX..........X.X....X...X....#................#...#.......X......X#..X..#.#..............X...........#..
.....#X..X...............X.XX..........X.X....X.#.X....................#............X##....XXXXXXXXXXXXXXXXXXXXXXXXXX#........#...
.....#X..X..#............X.XX.........#X.X....X...X..............#.....XXXXXXXXXXXXXXXXXXXXXXXXXXXXXXXXXXXXXXXXXXXXXXXXXXXXX#..#..
.#....X.#X............#..X.XX#.........X.X....X...X....................X.......#....X#.....XX..X.........##......#.XX......X......
......X..X............XXXXXXXXXXXXXXXXXXXXXXXXXXXXXXXXXXXXXXXXXXXXXXXXXXXXXXX##.....X......XX..X...................XX......X......
......X..X............X..X.XX..........X#XXXXXXXXXXXXXXXXXXXXXXXXXXXXXXXXXXXXXXX#...X....#.XX..X...................XX..#.#.X.....#
......X..X.#..........X..X.XX..........X.X....X..#X....................X....XX.#....X.#....XX#.X#..................XX#..#..X......
......X..X............X..X.XX..........X.X...#X...X..................#.X....XX......X...##.XX.#X....#..............XX......X......
......X..X............X.#XXXXXXXXXXXXXXXXXXXXXXXXXX....................X....XX......X..#...XX..X...................XX......X......
#.....X..X.....#......X....XX..........X.#....X...#...#...............#X....XX......X#.....XX..X........#..........XX......X.##...
...#..X#.X............X....XX........#.X.....#XXXXXXXXXXXXXXXXXXXXXXXXXXXXXXXXXXXXXXXXXXXXXXX.#X...................XX..#...X#.....
...XX#XXXXXXXXXXXXXXXXXXXXXXX..#..#....X..................#..........#.X....XX......X......#X..X..............#.#..XX.#....X......
...XX....X........#...X....#X.#.......#XXXXXXXXXXXXXXXXXXXXXXXXXXXXXXXXXXXXXXXXXXXXXXXXXXXXXXXXXXXXXXXXXXXXXXXXXXXXXX.....#X...#..
..#XX.#..X............X.....X.........................#.#..#...........X....XX......X.......X..X...................X#....#.X....#.
...XX....X.....#......X.....X..#..........................#............X....XX......X..#....X..X..#.............#..X.......X......
...XX....X..#.....#...X....#XXXXXXXXXXXXXXXXXXXXXXXXXXXXXXXXXXXXXXXXXXXXXXXXXX......X#......X.#X.......#.....#.....X..#....X.#....
...XX....X............X.....#.........#....#........#.....#...#........X....#XXXXXXXXXXXXXXXXXXX..............#....X.......X......
...XX...#X............X....#....#..........XXXXXXXXXXXXXXXXXXXXXXXXXXXXXXXXXXXXXXXXXXXXXXXX#X#.#...................X.......X......
...XX....X............X.........XXXXXXXXXXXXXXXXXXXXXXXXXXXXXXXXXXXXXXXXXXXXXXXXXXXXXXXXXXXXXXXXXXXXXXXXXXXXXXXXXXXX#......X......
#..XX....X...#........X....#....X..........X..#........................X............X.....X.X......................X.#.....X......
...XX....X............X........#X...#......X...#...........##..........X............X.....X.X......................X.#.....X...#.#
...XX....X......#.....X.........X..........X..............#.XXXXXXXXXXXXXXXXXXXXXXXXXXXXXXXXXXXXXXXXXXXXXXXX#......X.#.....X......
...XX....X............X.........X..........X..#............#X..........X....#.......X#....X.X..............X..#....X.......X......
...XX....X........#...X.....#...X..........X...........#....X........#.X............X#....X.X.....#........X.......X...#...X......
...XX....X............X.#...#...X..........X................X..........X....#.......X.....X#X....#XXXXXXXXXXXXXXXXXXXXX#...X......
...XX....X.#..........X.........X..........X.......#........X..........X..........#.X.....X.X.....X..#....#X..##...X..X....X......
#..XX....X......#.....X.........X..#.......X................X......#...X............X.....X.X.....X#.......X...XXXXXXXXXX#.X......
...XX....X...#........X.........X..XXXXXXXXXXXXXXXXXXXXXXXXXXXXXXXXXXXXXXXXXX##.....X.....X.X.....X........X...X...X..X.X..X......
...XX....X.......#....X........#X..X.......X...........#...#X..........X#.#.X..#....X.....X.X.....X........X...X#..X..X.X..X#.....
#..XX..#.X....#.......X.........X..X.......X.....##....XXXXXXXXXXXXX#.#XXXXXX.......X.....X.X.....X...#....X...X...X..X.X..X......
.#.XX....X.......#....X.....#...X..X.......X......XXXXXXXXXXXXXXXXXXXXXXXXXX#...#...X.....X#X.....X...#....X...X...X..X.X..X......
...XX....X............X.........X..X.#.....X......X....X....X.....#X...#...X....XXXXXXXXXXXXXXXXXXXXXXXXXXXXXXXXXXXXX#X.X#.X......
...XX.#..X#...........X.#.#.....X..X.......X...#..X....X.#..X......X##.XXXXXXXXXXXXXXXXXXXXXXXXXXXXXXXX#...X...X..#XXXXXXXXXX#....
...XX....X............X......#..X..X.......X....#.X..#.X....X......X##.X...X....X...X.....X.X#.#..X..#X....X..#XXXXXXXXXXXXXX.....
...XX....X............X.........X..X.......X.....#X#...X....X......XXXXXXXXXXXXXXXXXXXXXXXXXXXXXXXXXXXXXXX#X.......XXXX.X..#X.....
...XX....X............X.........X..X..#....X......X....X....X......XX..X...X....X#..X...#.X.X.....X...X..X.X.......XXXX.X...X.....
#..XX....X...........#XXXXXXXXXXXXXXXXXXXXXXXXXXXXXXXXXXXXXXXXXXXXXXX..X...X....X#..X.....X.X.....X.#.X..X.X.......XXXX.X...X.....
...XX#...X.....#................X..X.......X......X....X....X......#X..X#.#X...#X#..X.....X#X.....X...X..X.X.......XXXX.X...X.....
...XX...#X.........#......#.....X..X....#..X......X....X....X.......X..X.#.X...#X...X.....X.X...#.X...X..X.X.......XXXX.X...X.....
...XX....X.#....................X..X.......X#.....X....X#...X......#X..X..#X....X...X...#.X.X.....X...X..X.X.....#.XXXX.X...X.....
...XX..#.X.............#........X..X.......X#..#..X....X....X......XXXXXXXXXXXXXXXXXXXXXXXXXXXXX#.X...X..X.X.......XXXX.X...X.....
...XX....X...........#.........#X.#X.......X...#..X....X..#.X......XX.#X...X....X.#.X.....X.X..X..X...X..X.X......#XXXX.X...X.....
...XX....X......#...#........#..X..X.....#.X......X....X....X......XX..X...X....X.XXXXXXXXXXXXXXXXXX#.X#.X.X.......XXXX.X..#X.....
...XX....X..........XXXXXXXXXXXXXXXXXXXXXXXXXXXXXXXXXXXXX#..X......XX..X...X...#X.X#X.....X.X..X..XX..X..X#X#......XXXX.X..XXXXXX#
...XX....X......#...X..#....#.#.X..X.......X.#....X....XX.#.X......XX..X...X....X.X.X.....X.X..X..XX..X..X.X.......XXXX.X..XX...X.
...XX....X#.........X...........X..X.......X....#.X....XX...X......XX..X...X....X.X.X.....X.X..X..XX..X..X.X.......XXXX#X..XX...X.
#..XX....X..........X...........X..X...#...X...#..X..##XX#..X......XX..X...X...#X.X.X....#X.X..X.#XXXXXXXXXXXXXXXXXXXXXXXXXXXXXXX.
...XX...#X..#.......X......#....X..X.......X....#.X....XX...X......XX..X...X....X#X.X....XXXXXXXXXXXXXXXXXXXXXXXXXXXXXXXXXXXXXXX#.
.##XX....X..XXXXXXXXXXXXXXXXXXXXXXXXXXXXXXXXXXXXXXXXXXXXXXXXXXXXXXXXXXXXXXXXXXX#X.X.X.#..XX.X..X...X..X..X.X.......XXXX#X..XX..X..
.#.XX....X..X.......X.....#.....X..X.....#.X......X....XX...X......XX..X...X..X.X.X.X...#XX.X..X.#.X..X#.X.X...#...XXXX.X..XX..X..
#..XX....X..X.......X...........X..X...#...X......X....XX...X#.....XX..X...X..X.X.X.X....XX.X..X...X..X..X.X.......XXXX.X..XX..X.#
...XX....X..X.......X.......#...X.#X....#..X......X..#.XX...X......XX#.X.#.X..X.X#X.X....XX#XXXXXXXXXXXXXXXXXXXXXXXXXXX.X..XX..X..
.#.XX....X..X.......X......#....X..X.......X......X#...XX...X#.....XX#.X...X..X.X.X.X..#.XX....X...X..X..X.X.......X#XX#X..XX..X..
.XXXXXXXXXXXXXXXXXXXXXXXXXXXXXXXXXXXXXXXXXXXXXXXXXXXXXXXXXXXXXXXXXXXXXXXXXXXXXXXXXXXXXXXXXXXXXXXXXXXXXXXXXXXX#.....X..##X..XX..X..
.X.XX....X.#X..#...#X#..........X..X..#....X......X....XX...X......XX..X...X#.X.X.X.X#...XX....X...X..X..X.XX......X....X..XX..X..
.X.XX.#..X..X.......X.........#.X..X.....#.X.....#X....XX...X......XX..X...XXXXXXXXXXXXXXXXXXXXXXXXXXXXXXXXXXXXXXX#XXXXXXXXXX..X..
.X.XX...#X..X#......X.#.........X..X.....#.X..##..X..#.XX...X.....#XX..X...XX.X.X.X.X....XX....X.#.X..X..X.XX#...X.X....X#.X#..X..
.X.XX....X..X.......X...........X.#XXXXXXXXXXXXXXXXXXXXXXXXXXXXXXXXXXXXXXXXXXXXXXXXXX....XX....X...X..X..X.XX....X#X....X..X...X..
.X.XX....X..X.......X#.#........X..........X...#..X....XX...X......XX..X...XX.X.X.X.#....XX....X...X..X..X.XX....X.X....X..X...X..
.X.XX....X..X.......X..XXXXXXXXXXXXXXXXXXXXXXXXXXXXXXXXXXXXXXXXXXXXXXXXXXXXXXXXXXXXXXXXX#XX....X..#X..X..X.XX....X.X#...X..X..#X..
.X.XX....X..X.......X..X..#.....X....#....#X......X....XX...X......XX..X...XX.X.X.X..#.X.XX....X...X..X..X.XX#...X.X....X.#X#..X..
.X.XX....X..X.......X..X........X..........X...#.#X...#XX...X......XX..X...XX.X.X.X...#X.XX....X...X..X..X#XX....X.X....X..X...X.#
.X.XX#...X..X....#..X..X..#.#...X...#......X......X....XX...X.....#XX..X...XX.X.X.X..#.X.XX....X...X..X..X.XX....X.X....X..X...X..
.X.XX....X..X..#....X..X........X..........X......X....XX...X......XX..X.#.XX.X.X.X....X.XX...#X...X..X..X.XX...#X.X....X..X..#X..
#X.XX....X..X.......X..X........X....##....X.....#XXXXXXXXXXXXXXXXXXXXXXXXXXXXXXXXXXXXXXXXXXXXXXXXXXXXXXXXXXX....X#X....X..X...X..
.X.XX....X..X..#....X..X........X#...#.....X........#..XX...X......XX..X...XX.X.X.X....X.XX....X...X..X..X.#X....X.X....X.#XXXXX..
.X.XX....X..X......#X..X..#.....X..........X...........XX...X......XX..X#..XX.X.X.X....X.XX....X...X..X..X..X....X.X....X......#.#
.X#XXXXXXX..X...#...X..X#......#X...#..#..#XXXXXXXXXXXXXXXXXXXXXXXXXXXXXXXXXXXXXXXXXXXXXXXXXXXXXXXXXXXXXXXXXXXXXXXXX....X.........
.X..X....#..X.......X..X........X......................XX...X.#....XX..X...XX.X.X.X....X.XX....X...X#.X..X..X....X.#....X.........
.X..X.......X.#.....X..X.....#..X......................XX...X.XXXXXXXXXXXXXXXXXXXXXXXXXXXXXXXX#X...X..X..X..X....X....#.X.........
.X..X.......X.......X..X..#.....X...........#..........XX...X.X....XX..X...XX.X.X.X....X.XX..X.X...X##X..X..X....X......X#.#......
.X..X.......X..#..#.X..X........X......................XX...X.X....XX..X...XX.X.X.X....X.XX..X.X...X.XXXXXXXXXXXXXXXXX#.X.....###.
.X.#X.......X.......X..X.#..#...X....#..........#......XX...X.X....XX..X...XX.X.X.X....X.XX..X.X...X.XX..X..X....X.##X..X.........
.X..X.......X....#..X..X........X......................XX###X.X....XX..X..#XX.X.X.X....X.XX..X.X...X#XX..X..X....X...X..X.........
.X.#X.......X.......X..X........X......................XX#..X.X..#.XX..X...XX.X.X.X....X.XX.#X.X...X.XX..X..X#..#X...X..X.........
.X..X.......X.......X..X........X..................#...XX...X.X....XX.#X...XX.X.X.X....X.XX..X.X...X.XX..X..X....X...X..X.......#.
.X..X#......X......#X..X........X......#...............XX..#X.X....XX..X...XX.X.X.X....X.XX..X.X.#.X.XX..X..X....X...X..X.........
.X..X.......X.......X#.X........X..............#......#XXXXXXXXXXXXXXXXXXXXXXXXXXXXXXXXXXXXXXXXX...X.XX..X..X....X...X..X.........
.X..X......#X.......X..X...#....X.#.....##...#...#......X...X.X....XX..X...XX.X.X.X....X.XX..X.#...X.XX.#X#.X....X...X..X.#...#...
.X..X.......X.#.....X..X.....##.X.........#.............X...X.X...#XX#.X...XX.X.X.X....X.XX..X.....X.XX..X..X....X...X..X.........
.X..X.......X......#XXXXXXXXXXXXXXXXXXXXXXXXXXXXXXXXXXXXXXXXXXXXXXXXXXXXXXXXX.X.X.X....X.XX..X.....X.XX..X..X....X...X..X.........
.X..X.......X.....#....X..#.....X....#.......#..........X...X.X.#..XX......#X.X.X.X....X.XX..X.....X.XX..X..X..#.X...X..X.........
.X..X.......X..........X........X.......................X...X.X....XX.......X.X.X.X....X.XX..X#....X.XX..X..X....X...X..X........#
.X..X.......X..........X........X.....................#.X...X.X....XX..#....X.X.X.X....X.XX..X#....X.XX..X..X....X...X..X.........
.X..X.......X.#........X#.......X......................#X...X.X....XX.......X#X.X.X....X.XX..X.....X#XX..X..X....X...X..X.........
#XXXX.......X....#.....X...#....X...........#...........X...X.X....XX.....#.X.X.X.X....X.XX..X...#.X#XX.#X..X....X...X.#X.........
.#..#.......X#.........X......#.X.............#.........X...X.X..#.XX.....#.X.X.X.X....X.XX..X..#..X.XX..X..X#...X...X#.X.........
............X..........X........X....................#.#X...X.X..#.XX.......X.X.X.X....X#XXXXXXXXXXXXXXXXXXXXXXXXXXXXX#.X......#..
............X.........#X........X...........#..#......#.X...X.X....XX.......X.X.X#X....X..X..X.....X.XX..X..X.#..X...#..X.........
............X.........#X........X...............#..#....X...X.X....XX.......X.X.X.X...#X..X..X.....X.XX..X..X.#..X......X....#....
............X..........X..#.....X............#..........X..#XXXXXXXXXXXXXXXXXXXXXXXXXXXXXXXXXXXXXXXXXXX..X..X....X#.....X.........
............X..........X..#....#XXXXXXXXXXXXXXXXXXXXXXXXX.....X....XX...#..#X.X#X.X.#..X..X..X.....X.X#..X..X....X......X.........
.......#....X......#...X...................#............##....X...#XXXXXXXXXXXXXXXXXXXXX..X..X.....X.X...X..X....X.....#X.........
#...........X..........X................................XXXXXXXXXXXXXXXXXXX#XXX.X.X....#..X..X.....X.X...X..X....X......X.........
............X..........X................................X...#.X.....X.....X...#.X#XXXXXXXXXXXXXXXXXXXXXXXX..X....X......X.##......
..#.........X..........X..........................#....#XXXXXXXXXXXXXXXXXXXXXXXXXXXXXXXXXXXXXXXXXXXX.X...##.X...#X..##..X..#......
...#.....##.X..........X.................#....................X.....X.....X.....X.........X..X.....#.X......X...#X......^.........
.....#....##X..........X................#....##..........#...#XXXXXXXXXXXXXXXXXXXXXXXXXXXXXXXXXXXXXXXXXXXXXXXXXXXXXXXXXXX.........
............X..........X..........................#.................X.....X..#..X......##.X..X..#....X......X....X......#.........
.........#..X..#.......X..#........#........................#.##..#.X.....X....#XXXXXXXXXXXXXXXXXXXXXXXXXXXXXXXXXX.....#..........
.....#......X........#.X.....#..........#.#..........#..............X.....X#..............X..X.......X......X....#.....#..........
....#......#XXXXXXXXXXXXXXXXXXXXXXXXXXXXXXXXXXXXXXXXXXXXXXXXXXXXXXXXXXXXXXXXXXXXXXXXXXXXXXXXXX.......X..##..X#.#.#.........#......
...........#...........X............#.....#....................#....X.....X.......#.#.....X..#.......X......X.....................
.......................X............................#...............X#.#..X...............X..........X......X...........#.........
..........#............X.#.......................#.................#XXXXXXXXXXXXXXXXXXXXXXX..........X.#....X........#.#......##..
................##.....X................................................#.X...............#.......#.#XXXXXXXX............#........
................#......X...............................................#..X..........##...............#.....#......#.......#......
.......................X......#............................#..........#...X.......#...............................................
.......#.............#.X..................................................X...............#..............................#.#......
...#...................X.#.#..............................................X................#...#..#....#..........................
....#.........##......#XXXXXXXXXXXXXXXXXXXXXXXXXXXXXXXXXXXXXXXXXXXXXXXXXXXX..........................#..................#.........
....#..........................................#......#...................#........##............#................................
..#.......#......#............#........#...#.#...........................#.......#................................................
..........................#...#....................#...............#...#......#.#...#...#...............#.#.#.....................
....##.#....................................................................#...#.....##........................#.##..............
.............................................#....................................................................................
